MIR = "countries/Mir.txt"
BOF = "countries/Bofan.txt"
XIA = "countries/Ternfol-Siakia.txt"
SLA = "countries/Slandsko.txt"
SAS = "countries/Sasmador.txt"
PIN = "countries/Pinoplus.txt"
ELO = "countries/Elongal.txt"
REM = "countries/Remland.txt"
RIN = "countries/Rinor.txt"
ANS = "countries/Ansvebia.txt"
TRS = "countries/Tarsouhtagazer.txt"
POD = "countries/Poratesdorf.txt"
BBL = "countries/BlackBorderlands.txt"
DOK = "countries/Dokozam.txt"
VEL = "countries/Velburx.txt"
JOK = "countries/Jokk.txt"
ZOK = "countries/Zoktonz.txt"
SHT = "countries/Shot.txt"
KOM = "countries/Komofolk.txt"
SBI = "countries/San-Biand.txt"
KRA = "countries/Kratan.txt"
NON = "countries/Norneast.txt"
RON = "countries/Roname.txt"
VEG = "countries/Vegiva.txt"
PUV = "countries/Puvo Denpo.txt"
REK = "countries/Rekavia.txt"
STR = "countries/Stratenaand.txt"
CLP = "countries/Colpale.txt"
MLY = "countries/Mol Yto.txt"
MLM = "countries/Mol Malay.txt"
CEG = "countries/Cegipsko.txt"
ARV = "countries/Arvanta.txt"
ERM = "countries/Ermio.txt"
NRM = "countries/Noriam.txt"
TAR = "countries/Tarkeia.txt"
SVI = "countries/Svito.txt"